2111111111111111111111112
1000000000000000000000001
1000000000001000000000001
1000000000001000000000001
1000000000001000000000001
1000000011111111100000001
1000000000001000000000001
1000000000001000000000001
1000000000001000000000001
1000000000000000000000001
1000000000000000000000001
1000000000000000000000001
1000000011111111100000001
1000000000000000000000001
1000000000000000000000001
1000000000000000000000001
1000000000001000000000001
1000000000001000000000001
1000000000001000000000001
1000000011111111100000001
1000000000001000000000001
1000000000001000000000001
1000000000001000000000001
1000000000000000000000001
2111111111111111111111112
