2111111111111111111111112
1000000000000000000000001
1000000000000000000000001
1000001111111111110000001
1000000000000000010000001
1000000000000000010000001
1000000000000000010000001
1000000001000000010000001
1000000001000000010000001
1000000001000000010000001
1000000001000000000000001
1000000001000000000000001
1000000001000000000000001
1000000000000000000000001
1000000000000000000000001
1000000000000000000000001
1000000111111111111000001
1000000000000000000000001
1000000000000000000000001
1000000000000000000000001
1000000111111111111000001
1000000000000000000000001
1000000111111111111000001
1000000000000000000000001
2111111111111111111111112
